{
  "drawing-1-local-remote": {
    "frames": [
      [0,1,2,13],
      [0,1,2,13,3,4,5],
      [0,1,2,13,3,4,5,6,7,8],
      [0,1,2,13,3,4,5,6,7,8,9,10,11,12]
    ]
  },
  "drawing-2-commit-cycle": {
    "frames": [
      [0,1,2,10,11,18],
      [0,1,2,10,11,18,3,4,5,6,7],
      [0,1,2,10,11,18,3,4,5,6,7,8,9,12,13],
      [0,1,2,10,11,18,3,4,5,6,7,8,9,12,13,14,15,16,17],
      [0,1,2,10,11,18,3,4,5,6,7,8,9,12,13,14,15,16,17,19,20,21,22,23]
    ]
  },
  "drawing-3-branching": {
    "frames": [
      [0,1,2,3,8],
      [0,1,2,3,8,4,5],
      [0,1,2,3,8,4,5,6,7],
      [0,1,2,3,8,4,5,6,7,9,10]
    ]
  },
  "drawing-4-pull-request": {
    "frames": [
      [0,1,2,3,4,5,6,7],
      [0,1,2,3,4,5,6,7,15,12,13,14],
      [0,1,2,3,4,5,6,7,15,12,13,14,8,9,10,11],
      [0,1,2,3,4,5,6,7,15,12,13,14,8,9,10,11,16,17,18]
    ]
  }
}
